1 1 1 1 1 1 1 1 1 1 1 1 1 1 1 1
1 0 1 2 3 4 5 6 7 8 0 0 0 1 0 1
1 0 0 0 0 0 1 0 0 0 0 0 0 1 0 1
1 0 0 0 0 0 9 0 0 1 0 0 0 0 0 1
3 0 1 0 0 0 3 4 0 1 0 0 0 1 0 1
3 0 1 0 0 0 0 0 0 1 0 0 0 1 0 1
3 0 1 1 1 0 0 0 0 0 0 0 0 0 0 1
3 0 0 0 0 0 0 0 0 0 0 0 0 0 0 1
3 3 3 3 3 8 1 1 1 1 1 1 1 1 1 1